0000000000000000000000000000000
0000000100000001000001000000000
0000011B 1 11111 1111C  110000000
0000010001001000010010010000000
0000110001001000010010011100000
0000 00000001 00 10000000100000
000011 111000100100111 11100000
0000001001000100100100100000000
0001111001111100111100111110000
011 0000000000000000000000 1110
0001111100011101110001111110000
0000000 0001010101000 000000000
0011111100010101010001111111000
00100000111 01010 1110000001000
0010000000010101010000000001000
0010000000010101010000000001000
00 1111 111 11 11 111 11111 000
0001000100010010010001000010000
0001010001000010000100010010000
00011 111P 111111111 111 1110000
0000000000000000000000000000000